112121212121211
1             1
1             1
1      0      1
1             1
1             1
1             1
1             1
1             1
1122     111111
1  2          1
1  2          1
1  1      2   1
1             1
112121212121211
