112121212121211
1       2 2   1
1 2121222 2 111
1      22 2   1
1      22 22  1
112121 22222  1
1  1       2  1
1  1    0     1
1          2  1
1122  111111111
1  2          1
1  2212 1 21  1
1  1          1
1             1
112121212121211
