1112112111111111
2              1
1  0  111111   1
1     1        1
1     2  1111111
3     1        1
1   21111      1
1   1   11111  1
1   1   1      1
1   1   1  11111
1       1      1
1       1      1
1       1      1
1 2211111      1
1              1
1111111111111111