   1111111111111
  1   1        1
 1    2  1111111
1    1        1
1   21111      1
1   1   11111  1
1       1      1
1    0  1  11111
1       1      1
1       1      1
1       1      1
1 1111111      1
1              1
1111111111111111